# ## ############## ##### ######## ########################## #############
# ##             ## ## ##       ## ## ##    ## ## ## ## ##                #
# ## ## ########### ######## ## ############## ######## ##### ## ######## #
# ## ## ########### ######## ## ############## ######## ##### ## ######## #
# ##             ##             ##       ## ##    ##          ##    ##    #
# ## ##### ## ## ## ## ## ##### ##### ## ######## ######## ## ##### ## ####
# ## ##### ## ## ## ## ## ##### ##### ## ######## ######## ## ##### ## ####
#    ##       ## ##       ##             ## ## ##                ##        
#### ## ######## ## ## ##### ##### ## ######## ## ##### ## ## #############
#### ## ######## ## ## ##### ##### ## ######## ## ##### ## ## #############
# ## ##    ## ## ## ## ##                ##          ##                ##  
#### ####################### ## ########### ######## ## ########### ## ## #
#### ####################### ## ########### ######## ## ########### ## ## #
  ##    ##    ## ##    ## ##    ##    ##    ## ## ##          ## ##    ## #
####### ##### ## ######## ##### ##### ## ##### ##### ## ## ## ## ## ##### #
####### ##### ## ######## ##### ##### ## ##### ##### ## ## ## ## ## ##### #
#          ##       ## ## ##          ##    ## ##    ##       ## ##    ##  
####### ######## ##### ## ## ## ## ## ## ########### ## ## ##### ##### ## #
####### ######## ##### ## ## ## ## ## ## ########### ## ## ##### ##### ## #
              ## ## ## ##    ##    ## ##    ##    ## ## ##          ## ## #
# ##### ##### ## ## ######## ##### ######## ######## ## ## ######## ## ####
# ##### ##### ## ## ######## ##### ######## ######## ## ## ######## ## ####
# ## ## ## ##    ##             ## ##       ##    ##             ##    ##  
#### ############## ############## ######## ######## ##### ## ## ## ## ## #
#### ############## ############## ######## ######## ##### ## ## ## ## ## #
     ##    ##       ## ## ##    ## ##    ##    ##    ## ##    ## ##       #
# ## ##### ########### ##### ## ## ## ########### ##### ## ## ## ## ##### #
# ## ##### ########### ##### ## ## ## ########### ##### ## ## ## ## ##### #
# ##    ## ## ##    ##       ## ##       ##    ##          ## ##       ##  
# ## ## ######## ## ## ## ##### ##### ##### ## ## ## ## ## ######## ## ####
# ## ## ######## ## ## ## ##### ##### ##### ## ## ## ## ## ######## ## ####
  ## ## ## ##          ##    ## ##    ##    ##    ##             ## ## ## #
# ## ## ## ##### ## ######## ######## ######## ## ##### ## ##### ## ##### #
# ## ## ## ##### ## ######## ######## ######## ## ##### ## ##### ## ##### #
#  # ## ##    ## ##             ## ## ##             ## ##          ##    #
# ## ##### ## ## ######## ######## ########### ## ######## ##### ##### ## #
# ## ##### ## ## ######## ######## ########### ## ######## ##### ##### ## #
# #        ## ##          ## ## ##    ##       ##          ## ## ## ## ## #
# ######## ########### ## ##### ## ## ## ## ## ## ##### ########### ## ## #
# ######## ########### ## ##### ## ## ## ## ## ## ##### ########### ## ## #
# ##       ##          ##    ## ##    ## ##    ##    ## ##       ## ## ##  
#### ##### ######## ##### ##### ## ##### ########### ## ######## ## ##### #
#### ##### ######## ##### ##### ## ##### ########### ## ######## ## ##### #
  ## ##    ## ## ##          ## ## ## ## ##    ## ##    ## ##    ##        
# ## ## ## ##### ##### ##### ##### ##### ## ##### ## ## ## ## ## ##### ## #
# ## ## ## ##### ##### ##### ##### ##### ## ##### ## ## ## ## ## ##### ## #
        ## ##    ##             ## ## ## ##       ##    ##    ## ## ## ##  
########## ######## ##### ######## ## ##### ## ## ## ######## ## ## #######
########## ######## ##### ######## ## ##### ## ## ## ######## ## ## #######
  ##    ##    ##    ##          ## ## ## ##       ##    ##    ## ## ## ## #
#### ## ##### ## ##### ## ##### ## ## ## ## ## ##### ## ## ########### ## #
#### ## ##### ## ##### ## ##### ## ## ## ## ## ##### ## ## ########### ## #
# ## ##    ## ##             ## ## ## ##    ## ##             ##       ## #
# ########### ## ##### ## ## ##### ## ## ##### ## ##### ############## ## #
# ########### ## ##### ## ## ##### ## ## ##### ## ##### ############## ## #
  ## ##       ##    ##    ##    ##    ##       ##                         #
# ######## ## ######## ## ## ## ## ## ## ##### ######## ## ## ## ######## #
# ######## ## ######## ## ## ## ## ## ## ##### ######## ## ## ## ######## #
#       ## ##                   ## ##    ##       ##          ##    ##    #
# ########### ########### ######## ## ########### ##### ##### #############
# ########### ########### ######## ## ########### ##### ##### #############
  ## ##    ##    ## ## ##          ## ##             ##    ## ##          #
########## ##### ## ######## ## ## ## ##### ## ## ## ########### ######## #
########## ##### ## ######## ## ## ## ##### ## ## ## ########### ######## #
        ##    ##          ##          ##    ##             ##    ##       #
####### ##### ##### ## ##### ########### ##### #################### #######
####### ##### ##### ## ##### ########### ##### #################### #######
#                   ## ## ##    ##    ##    ##       ## ##       ##       #
# ##### ##### ## ## ## ########### ## ##### ############## ## ## ## ##### #
# ##### ##### ## ## ## ########### ## ##### ############## ## ## ## ##### #
#       ##    ## ## ##    ##             ##       ##    ## ##    ##    ##  
# ##### ##### ## ## ##### ## ##### ######## ##### ## ## ## ## ## ## ## ####
# ##### ##### ## ## ##### ## ##### ######## ##### ## ## ## ## ## ## ## ####
   #          ## ##       ##    ## ##    ## ##    ##    ##             ## #
########## ##### ####################### ## ## ## ## ######################

